111111111111111111111
10010000000C000000001
100001111100000000001
100001111100000000001
1000011111000000X0001
1000011111000000X0001
100001111100000000001
100001111100000000001
1C0011ECPCC0000000001
111111111111111111111