111111111111111111111
10010000000C000000001
100001111100000000001
100001111100000000001
100001111100000000001
100C01111100000000001
10000111110X000000001
100001111100000000001
1000011111000000000X1
100001111100000000XC1
1000011111000000000X1
100001111100000000001
100001111100000000001
100001111100000000001
1C0011EP0000000000001
111111111111111111111