1111111111111
1001000000001
1000C11111001
1P0011E000001
1111111111111