


1111111111111111111111111
10010000000C0000000000001
10000111111111111111111C1
1P001100001000100010C0101
1000110E00001000100010001
1111111111111111111111111


