11111111
100000C1
1P011E01
11111111