111111111111111111
1000000100000000C1
101111000001111111
1000111111001C0001
111011EP0000111101
1C0011111110000001
111111111111111111