11111
1P001
111C1
10201
10111
100E1
11111