111111111111111111111
10010000000C000000001
100001111100000000001
100001111100000000001
100001111100000000001
100001111100000000001
100001111100000000001
100001111100000000001
100001111100000000011
1000011111000000001C1
100001111100000000011
100001111100000000001
100001111100000000001
100001111100000000001
1P0011E00000000000001
111111111111111111111