111111
1P0001
110001
1C10E1
111111