111111111111111111
10010000000C000111
1000011111000001C1
100001111100000111
1P0011E00000000001
111111111111111111